"aM" = (/obj/structure/fence,/obj/effect/turf_decal/road/line/transparent/white,/turf/open/floor/concrete/pavement,/area/space)
"aV" = (/turf/closed/wall/concrete/reinforced,/area/space)
"bF" = (/turf/open/floor/carpet,/area/space)
"dE" = (/obj/structure/table,/turf/open/floor/plating/rust/wasteplanet,/area/space)
"eI" = (/obj/structure/fence/corner,/turf/open/floor/plating/asteroid/wasteplanet,/area/space)
"eN" = (/obj/effect/decal/cleanable/vomit/old,/turf/open/floor/plasteel/showroomfloor,/area/space)
"eZ" = (/turf/open/floor/concrete/slab_1,/area/space)
"fu" = (/obj/structure/fence{dir = 8},/obj/structure/sign/warning/radiation/rad_area,/turf/open/floor/plating/asteroid/wasteplanet,/area/space)
"hr" = (/obj/structure/fluff/glowshroom,/turf/open/floor/plating/asteroid/wasteplanet,/area/space)
"hZ" = (/obj/structure/salvageable/computer{dir = 4},/turf/open/floor/plasteel/patterned/cargo_one,/area/space)
"iW" = (/obj/structure/closet/crate,/turf/open/floor/concrete/tiles,/area/space)
"lq" = (/obj/structure/fence{dir = 8},/turf/open/floor/plating/asteroid/wasteplanet,/area/space)
"lC" = (/turf/open/floor/plasteel/patterned/cargo_one,/area/space)
"mJ" = (/obj/effect/turf_decal/trimline/transparent/white/filled/warning{dir = 5},/turf/open/floor/concrete/pavement,/area/space)
"ns" = (/obj/structure/fence{dir = 8},/obj/structure/sign/mining/survival{desc = "A high visibility sign designating a condemned area."; name = "CONDEMNED AREA sign"},/turf/open/floor/plating/asteroid/wasteplanet,/area/space)
"nu" = (/turf/open/floor/plating/wasteplanet,/area/space)
"nw" = (/obj/effect/turf_decal/borderfloor/corner,/turf/open/floor/concrete/tiles,/area/space)
"ou" = (/obj/effect/turf_decal/corner/opaque/nsorange/border{dir = 5},/turf/open/floor/plasteel/patterned/cargo_one,/area/space)
"qI" = (/obj/structure/closet/crate/radiation,/turf/open/floor/concrete/tiles,/area/space)
"qY" = (/obj/structure/table,/obj/item/pen/fourcolor{pixel_x = -8; pixel_y = 8},/obj/item/folder/yellow{pixel_x = 7; pixel_y = 6},/obj/effect/turf_decal/corner/opaque/nsorange/border{dir = 7},/turf/open/floor/plasteel/patterned/cargo_one,/area/space)
"rv" = (/obj/effect/turf_decal/borderfloor{dir = 4},/turf/open/floor/concrete/tiles,/area/space)
"sz" = (/obj/structure/table,/obj/effect/turf_decal/corner/opaque/nsorange/border{dir = 18},/turf/open/floor/plasteel/patterned/cargo_one,/area/space)
"te" = (/obj/structure/crate_shelf,/turf/open/floor/concrete/tiles,/area/space)
"ub" = (/obj/machinery/door/airlock/mining/glass{dir = 4; name = "Cargo"},/turf/open/floor/plasteel/patterned/grid,/area/space)
"vw" = (/obj/machinery/door/window,/obj/machinery/shower{pixel_x = 0; pixel_y = 22},/turf/open/floor/noslip,/area/space)
"xk" = (/obj/effect/turf_decal/borderfloor/corner{dir = 4},/turf/open/floor/concrete/tiles,/area/space)
"zh" = (/obj/structure/toilet{dir = 4; pixel_x = -4; pixel_y = 1},/turf/open/floor/plasteel/showroomfloor,/area/space)
"At" = (/turf/open/floor/plasteel/patterned/grid,/area/space)
"Bv" = (/turf/open/floor/carpet/cyan,/area/space)
"Da" = (/obj/effect/turf_decal/road/line/transparent/white,/turf/open/floor/concrete/pavement,/area/space)
"Dt" = (/obj/machinery/door/airlock/freezer{id_tag = "reactorbathroombolt"; name = "Bathroom"},/turf/open/floor/plasteel/showroomfloor,/area/space)
"DG" = (/turf/open/floor/plating/rust/wasteplanet,/area/space)
"Es" = (/turf/open/floor/plasteel/showroomfloor,/area/space)
"EP" = (/obj/effect/turf_decal/borderfloor{dir = 1},/turf/open/floor/concrete/tiles,/area/space)
"Fj" = (/obj/structure/table,/obj/effect/turf_decal/corner/opaque/nsorange/border{dir = 8},/turf/open/floor/plasteel/patterned/cargo_one,/area/space)
"Ga" = (/obj/structure/table,/obj/item/megaphone/cargo,/obj/effect/turf_decal/corner/opaque/nsorange/border{dir = 8},/turf/open/floor/plasteel/patterned/cargo_one,/area/space)
"Hg" = (/turf/closed/mineral/random/wasteplanet,/area/space)
"In" = (/obj/effect/turf_decal/corner/opaque/nsorange/border{dir = 4},/turf/open/floor/plasteel/patterned/cargo_one,/area/space)
"IW" = (/obj/effect/turf_decal/borderfloor{dir = 6},/turf/open/floor/concrete/tiles,/area/space)
"IZ" = (/obj/structure/sink{dir = 4; pixel_x = -12},/turf/open/floor/plasteel/showroomfloor,/area/space)
"Jv" = (/obj/effect/turf_decal/road/line/transparent/white,/obj/effect/turf_decal/trimline/transparent/white/filled/warning{dir = 4},/turf/open/floor/concrete/pavement,/area/space)
"JF" = (/obj/structure/closet/crate/engineering,/turf/open/floor/concrete/tiles,/area/space)
"Kf" = (/turf/open/floor/carpet/green,/area/space)
"Kg" = (/turf/closed/indestructible/reinforced,/area/space)
"Mg" = (/obj/effect/turf_decal/borderfloor,/turf/open/floor/concrete/tiles,/area/space)
"Oq" = (/obj/structure/fence,/turf/open/floor/concrete/pavement,/area/space)
"OL" = (/obj/structure/closet/crate/internals,/turf/open/floor/concrete/tiles,/area/space)
"OS" = (/obj/structure/fence/corner{dir = 1},/turf/open/floor/plating/asteroid/wasteplanet,/area/space)
"Rn" = (/obj/structure/fence,/turf/open/floor/plating/asteroid/wasteplanet,/area/space)
"SB" = (/turf/open/floor/concrete/pavement,/area/space)
"Tk" = (/turf/open/floor/plating/asteroid/wasteplanet,/area/space)
"Vd" = (/obj/effect/turf_decal/corner/opaque/nsorange/border{dir = 4},/obj/structure/chair/office{dir = 8},/turf/open/floor/plasteel/patterned/cargo_one,/area/space)
"Vo" = (/obj/structure/table,/obj/effect/turf_decal/corner/opaque/nsorange/border{dir = 10},/turf/open/floor/plasteel/patterned/cargo_one,/area/space)
"WY" = (/obj/machinery/button/door{id = "reactorbathroombolt"; dir = 8; pixel_x = 24; specialfunctions = 4},/turf/open/floor/plasteel/showroomfloor,/area/space)
"XD" = (/obj/effect/turf_decal/trimline/transparent/white/filled/warning{dir = 4},/turf/open/floor/concrete/pavement,/area/space)
"Yn" = (/turf/open/floor/carpet/blue,/area/space)
"ZB" = (/obj/effect/turf_decal/industrial/stand_clear/white{dir = 4},/turf/open/floor/concrete/slab_1,/area/space)
"ZI" = (/turf/open/floor/plasteel/white,/area/space)
"ZM" = (/turf/open/floor/concrete/tiles,/area/space)

(1,1,1) = {"
TkTkTkTkTkTkTkTkTkTkTkTkTkTkTkTkTkTkTkTkTkTkTkTkTkTkTkTkTkTkTkTkTkTkTkTkTkTkTkTkTkTkTkTkTkTkTkTkTkTkTkTkTkTkHgTkTkTkTkTkTkTkTkTkTkTkTkTkTkTkTkTkTkTkTkTkTkTkTkTkTkTkTkTkTkTkTkTkTkTkTkTkTkTkTkTkTkTkTkTk
TkTkTkTkTkTkTkTkTkTkTkTkTkTkTkTkTkTkTkTkTkTkTkTkTkTkTkTkTkTkTkTkTkTkHgTkHgTkTkTkTkTkTkHgTkTkTkTkTkTkTkTkTkHgHgTkHgTkHgHgHgHgHgHgHgHgHgHgTkTkTkTkTkTkTkTkTkTkTkTkTkTkTkTkTkTkTkTkTkTkTkTkTkTkTkTkTkTkTkTk
TkTkTkTkTkTkTkTkTkTkTkTkTkTkTkTkTkTkTkTkTkTkTkHgHgHgHgTkHgTkHgHgTkTkTkHgHgHgHgTkHgHgHgHgHgHgHgTkHgHgTkTkHgHgHgHgHgTkHgHgHgHgHgHgHgHgHgHgHgTkTkTkTkTkTkTkTkTkTkTkTkTkTkTkTkTkTkTkTkTkTkTkTkTkTkTkTkTkTkTk
TkTkTkTkTkTkTkTkTkTkTkTkTkTkTkTkTkTkHgTkTkTkHgHgHgHgHgHgHgHgHgHgHgHgHgHgHgHgHgHgHgHgHgHgHgHgHgHgHgHgHgHgHgHgHgHgHgHgHgHgHgHgHgHgHgHgHgHgHgTkTkTkTkTkTkTkTkTkTkTkTkTkTkTkTkTkTkTkTkTkTkTkTkTkTkTkTkTkTkTk
TkTkTkTkTkTkTkTkTkTkTkTkTkTkTkTkTkTkHgHgHgHgHgHgHgHgHgHgHgHgHgHgHgHgHgHgHgHgHgHgHgHgHgHgHgHgHgHgHgHgHgHgHgHgHgHgHgHgHgHgHgHgHgHgHgHgHgHgHgHgTkTkTkTkTkTkTkTkTkTkTkTkTkTkTkTkTkTkTkTkTkTkTkTkTkTkTkTkTkTk
TkTkTkTkTkTkTkTkTkTkTkTkTkTkTkTkTkTkHgHgHgHgHgHgHgHgHgHgHgHgHgHgHgHgHgHgHgHgHgHgHgHgHgHgHgHgHgHgHgHgHgHgHgHgHgHgHgHgHgHgHgHgHgHgHgHgHgHgHgHgTkTkTkTkTkTkTkTkTkTkTkTkTkTkTkTkTkTkTkTkTkTkTkTkTkTkTkTkTkTk
TkTkTkTkTkTkTkTkTkTkTkTkTkTkTkTkTkTkHgHgHgHgHgHgHgHgHgHgHgHgHgHgHgHgHgHgHgHgHgHgHgHgHgHgHgHgHgHgHgHgHgHgHgHgHgHgHgHgHgHgHgHgHgHgHgHgHgHgHgHgTkTkTkTkTkTkTkTkTkTkTkTkTkTkTkTkTkTkTkTkTkTkTkTkTkTkTkTkTkTk
TkTkTkTkTkTkTkTkTkTkTkTkTkTkTkTkTkTkTkHgHgHgHgHgHgHgHgHgHgHgHgHgHgHgHgHgHgHgHgHgHgHgHgHgHgHgHgHgHgHgHgHgHgHgHgHgHgHgHgHgHgHgHgHgHgHgHgHgHgTkTkTkTkTkTkTkTkTkTkTkTkTkTkTkTkTkTkTkTkTkTkTkTkTkTkTkTkTkTkTk
TkTkTkTkTkTkTkTkTkTkTkTkTkTkTkTkTkTkTkHgHgHgHgHgHgHgHgHgHgHgHgHgHgHgHgHgHgHgHgHgHgHgHgHgHgHgHgHgHgHgHgHgHgHgHgHgHgHgHgHgHgHgHgHgHgHgHgHgHgTkTkTkTkTkTkTkTkTkTkTkTkTkTkTkTkTkTkTkTkTkTkTkTkTkTkTkTkTkTkTk
TkTkTkTkTkTkTkTkTkTkTkTkTkTkTkTkTkTkTkHgHgHgHgHgHgHgHgHgHgHgHgHgHgHgHgHgHgHgHgHgHgKgKgKgKgKgKgKgKgKgHgHgHgHgHgHgHgHgHgHgHgHgHgHgHgHgHgHgHgTkTkTkTkTkTkTkTkTkTkTkTkTkTkTkTkTkTkTkTkTkTkTkTkTkTkTkTkTkTkTk
TkTkTkTkTkTkTkTkTkTkTkTkTkTkTkTkTkTkTkTkHgHgHgHgHgHgHgHgHgHgHgHgHgHgHgHgHgHgHgHgKgKgKgKgKgKgKgKgKgKgKgHgHgHgHgHgHgHgHgHgHgHgHgHgHgHgHgHgHgTkTkTkTkTkTkTkTkTkTkTkTkTkTkTkTkTkTkTkTkTkTkTkTkTkTkTkTkTkTkTk
TkTkTkTkTkTkTkTkTkTkTkTkTkTkTkTkTkTkTkTkHgHgHgHgHgHgHgHgHgHgHgHgHgHgHgHgHgHgHgKgKgKgTkTkTkTkTkTkTkKgKgKgHgHgHgHgHgHgHgHgHgHgHgHgHgHgHgHgHgTkTkTkTkTkTkTkTkTkTkTkTkTkTkTkTkTkTkTkTkTkTkTkTkTkTkTkTkTkTkTk
TkTkTkTkTkTkTkTkTkTkTkTkTkTkTkTkTkTkTkTkTkHgHgHgHgHgHgHgHgHgHgHgHgHgHgHgHgHgKgKgKgTkTkKgKgKgKgKgTkTkKgKgKgHgHgHgHgHgHgHgHgHgHgHgHgHgHgHgHgTkTkTkTkTkTkTkTkTkTkTkTkTkTkTkTkTkTkTkTkTkTkTkTkTkTkTkTkTkTkTk
TkTkTkTkTkTkTkTkTkTkTkTkTkTkTkTkTkTkTkTkTkHgHgHgHgHgHgHgHgHgHgHgHgHgHgHgHgKgKgKgTkTkKgKgKgKgKgKgKgTkTkKgKgKgHgHgHgHgHgHgHgHgHgHgHgHgHgHgHgTkTkTkTkTkTkTkTkTkTkTkTkTkTkTkTkTkTkTkTkTkTkTkTkTkTkTkTkTkTkTk
TkTkTkTkTkTkTkTkTkTkTkTkTkTkTkTkTkTkTkTkTkTkHgHgHgHgHgHgHgHgHgHgHgHgHgHgHgKgKgTkTkKgKgKgKgKgKgKgKgKgTkTkKgKgHgHgHgHgHgHgHgHgHgHgHgHgHgHgHgTkTkTkTkTkTkTkTkTkTkTkTkTkTkTkTkTkTkTkTkTkTkTkTkTkTkTkTkTkTkTk
TkTkTkTkTkTkTkTkTkTkTkTkTkTkTkTkTkTkTkTkTkTkHgHgHgHgHgHgHgHgHgHgHgHgHgHgHgKgKgTkTkKgKgKgTkTkTkKgKgKgTkTkKgKgHgHgHgHgHgHgHgHgHgHgHgHgHgHgHgHgTkTkTkTkTkTkTkTkTkTkTkTkTkTkTkTkTkTkTkTkTkTkTkTkTkTkTkTkTkTk
TkTkTkTkTkTkTkTkTkTkTkTkTkTkTkTkTkTkTkTkTkTkHgHgHgHgHgHgHgHgHgHgHgHgHgHgHgKgKgTkTkKgKgKgTkTkTkKgKgKgTkTkKgKgHgHgHgHgHgHgHgHgHgHgHgHgHgHgHgTkTkTkTkTkTkTkTkTkTkTkTkTkTkTkTkTkTkTkTkTkTkTkTkTkTkTkTkTkTkTk
TkTkTkTkTkTkTkTkTkTkTkTkTkTkTkTkTkTkTkTkTkTkTkHgHgHgHgHgHgHgHgHgHgHgHgHgHgKgKgTkTkKgKgKgTkTkTkKgKgKgTkTkKgKgHgHgHgHgHgHgHgHgHgHgHgHgHgHgHgHgTkTkTkTkTkTkTkTkTkTkTkTkTkTkTkTkTkTkTkTkTkTkTkTkTkTkTkTkTkTk
TkTkTkTkTkTkTkTkTkTkTkTkTkTkTkTkTkTkTkTkTkTkTkHgHgHgHgHgHgHgHgHgHgHgHgHgHgKgKgTkTkKgKgKgKgKgKgKgKgTkTkTkKgKgHgHgHgHgHgHgHgHgHgHgHgHgHgHgHgHgTkTkTkTkTkTkTkTkTkTkTkTkTkTkTkTkTkTkTkTkTkTkTkTkTkTkTkTkTkTk
TkTkTkTkTkTkTkTkTkTkTkTkTkTkTkTkTkTkTkTkTkTkTkHgHgHgHgHgHgHgHgHgHgHgHgHgHgKgKgTkTkTkKgKgKgKgKgKgKgTkTkTkKgKgHgHgHgHgHgHgHgHgHgHgHgHgHgHgHgHgTkTkTkTkTkTkTkTkTkTkTkTkTkTkTkTkTkTkTkTkTkTkTkTkTkTkTkTkTkTk
TkTkTkTkTkTkTkTkTkTkTkTkTkTkTkTkTkTkTkTkTkTkTkHgHgHgHgHgHgHgHgHgHgHgHgHgHgKgKgTkTkTkTkKgKgKgKgKgTkTkTkTkKgKgHgHgHgHgHgHgHgHgHgHgHgHgHgHgHgHgTkTkTkTkTkTkTkTkTkTkTkTkTkTkTkTkTkTkTkTkTkTkTkTkTkTkTkTkTkTk
TkTkTkTkTkTkTkTkTkTkTkTkTkTkTkTkTkTkTkTkTkTkTkHgHgHgHgHgHgHgHgHgHgHgHgHgHgKgKgTkTkTkTkTkTkTkTkTkTkTkTkTkKgKgHgHgHgHgHgHgHgHgHgHgHgHgHgHgHgTkTkTkTkTkTkTkTkTkTkTkTkTkTkTkTkTkTkTkTkTkTkTkTkTkTkTkTkTkTkTk
TkTkTkTkTkTkTkTkTkTkTkTkTkTkTkTkTkTkTkTkTkTkTkHgHgHgHgHgHgHgHgHgHgHgHgHgHgKgKgTkTkTkTkTkTkTkTkTkTkTkTkTkKgKgKgHgHgHgHgHgHgHgHgHgHgHgHgHgHgTkTkTkTkTkTkTkTkTkTkTkTkTkTkTkTkTkTkTkTkTkTkTkTkTkTkTkTkTkTkTk
TkTkTkTkTkTkTkTkTkTkTkTkTkTkTkTkTkTkTkTkTkTkTkTkHgHgHgHgHgHgHgHgHgHgHgHgHgKgKgTkTkTkTkTkTkTkTkTkTkTkTkKgTkKgKgKgHgHgHgHgHgHgHgHgHgHgHgHgTkTkTkTkTkTkTkTkTkTkTkTkTkTkTkTkTkTkTkTkTkTkTkTkTkTkTkTkTkTkTkTk
TkTkTkTkTkTkTkTkTkTkTkTkTkTkTkTkTkTkTkTkTkTkTkTkHgHgHgHgHgHgHgHgHgHgHgHgHgKgKgTkTkTkTkTkTkTkTkTkTkTkKgTkTkTkKgKgKgHgHgHgHgHgHgHgHgHgHgHgTkTkTkTkTkTkTkTkTkTkTkTkTkTkTkTkTkTkTkTkTkTkTkTkTkTkTkTkTkTkTkTk
TkTkTkTkTkTkTkTkTkTkTkTkTkTkTkTkTkTkTkTkTkTkTkTkHgHgHgHgHgHgHgHgHgHgHgHgHgKgKgTkTkTkTkTkTkTkTkTkTkKgTkTkTkTkTkKgKgKgHgHgHgHgHgHgHgHgHgHgTkTkTkTkTkTkTkTkTkTkTkTkTkTkTkTkTkTkTkTkTkTkTkTkTkTkTkTkTkTkTkTk
TkTkTkTkTkTkTkTkTkTkTkTkTkTkTkTkTkTkTkTkTkTkTkTkHgHgHgHgHgHgHgHgHgHgHgHgHgKgKgTkTkTkTkTkTkTkTkTkTkKgTkTkTkTkTkTkKgKgHgHgHgHgHgHgHgHgHgHgTkTkTkTkTkTkTkTkTkTkTkTkTkTkTkTkTkTkTkTkTkTkTkTkTkTkTkTkTkTkTkTk
TkTkTkTkTkTkTkTkTkTkTkTkTkTkTkTkTkTkTkTkTkTkTkTkHgHgHgHgHgHgHgHgHgHgHgHgHgKgKgTkTkTkTkTkTkTkTkTkTkKgTkTkTkTkTkTkKgKgHgHgHgHgHgHgHgHgHgHgTkTkTkTkTkTkTkTkTkTkTkTkTkTkTkTkTkTkTkTkTkTkTkTkTkTkTkTkTkTkTkTk
TkTkTkTkTkTkTkTkTkTkTkTkTkTkTkTkTkTkTkTkTkTkTkTkTkHgHgHgHgHgHgHgHgHgHgHgHgKgKgTkTkTkTkTkTkTkTkTkTkTkKgTkTkTkTkTkKgKgHgHgHgHgHgHgHgHgHgHgTkTkTkTkTkTkTkTkTkTkTkTkTkTkTkTkTkTkTkTkTkTkTkTkTkTkTkTkTkTkTkTk
TkTkTkTkTkTkTkTkTkTkTkTkTkTkTkTkTkTkTkTkTkTkTkTkHgHgHgHgHgHgHgHgHgHgHgHgHgKgKgTkTkTkTkTkTkTkTkTkTkTkTkKgTkTkTkTkKgKgHgHgHgHgHgHgHgHgHgTkTkTkTkTkTkTkTkTkTkTkTkTkTkTkTkTkTkTkTkTkTkTkTkTkTkTkTkTkTkTkTkTk
TkTkTkTkTkTkTkTkTkTkTkTkTkTkTkTkTkTkTkTkTkTkTkTkHgHgHgHgHgHgHgHgHgHgHgHgHgKgKgTkTkTkTkTkTkTkTkTkTkTkTkTkKgTkTkTkKgKgHgHgHgHgHgHgHgHgHgTkTkTkTkTkTkTkTkTkTkTkTkTkTkTkTkTkTkTkTkTkTkTkTkTkTkTkTkTkTkTkTkTk
TkTkTkTkTkTkTkTkTkTkTkTkTkTkTkTkTkTkTkTkTkTkTkTkHgHgHgHgHgHgHgHgHgHgHgHgHgKgKgTkTkTkTkTkTkTkTkTkTkTkTkTkKgTkTkTkKgKgHgHgHgHgHgHgHgHgHgHgHgTkTkTkTkTkTkTkTkTkTkTkTkTkTkTkTkTkTkTkTkTkTkTkTkTkTkTkTkTkTkTk
TkTkTkTkTkTkTkTkTkTkTkTkTkTkTkTkTkTkTkTkTkTkTkTkHgHgHgHgHgHgHgHgHgHgHgHgHgKgKgTkTkTkTkTkTkTkTkTkTkTkTkTkKgTkTkTkKgKgHgHgHgHgHgHgHgHgHgHgHgHgTkTkTkTkTkTkTkTkTkTkTkTkTkTkTkTkTkTkTkTkTkTkTkTkTkTkTkTkTkTk
TkTkTkTkTkTkTkTkTkTkTkTkTkTkTkTkTkTkTkTkTkTkTkTkTkHgHgHgHgHgHgHgHgHgHgHgHgKgKgTkTkTkTkTkTkTkTkTkTkTkTkTkKgTkTkTkKgKgHgHgHgHgHgHgHgHgHgHgHgTkTkTkTkTkTkTkTkTkTkTkTkTkTkTkTkTkTkTkTkTkTkTkTkTkTkTkTkTkTkTk
TkTkTkTkTkTkTkTkTkTkTkTkTkTkTkTkTkTkTkTkTkTkTkTkTkTkHgHgHgHgHgHgHgHgHgHgHgKgKgKgTkTkTkTkTkTkTkTkTkTkTkKgKgTkTkTkKgKgHgHgHgHgHgHgHgHgHgHgHgHgTkTkTkTkTkTkTkTkTkTkTkTkTkTkTkTkTkTkTkTkTkTkTkTkTkTkTkTkTkTk
TkTkTkTkTkTkTkTkTkTkTkTkTkTkTkTkTkTkTkTkTkTkTkTkTkTkHgHgHgHgHgHgHgHgHgHgHgHgKgKgKgTkTkTkTkTkTkTkTkTkKgKgKgTkTkTkKgKgHgHgHgHgHgHgHgHgHgHgHgHgTkTkTkTkTkTkTkTkTkTkTkTkTkTkTkTkTkTkTkTkTkTkTkTkTkTkTkTkTkTk
TkTkTkTkTkTkTkTkTkTkTkTkTkTkTkTkTkTkTkTkTkTkTkTkTkTkTkHgHgHgHgHgHgHgHgHgHgHgHgKgKgKgKgTkTkTkTkTkKgKgKgKgKgTkTkTkKgKgHgHgHgHgHgHgHgHgHgHgHgTkTkTkTkTkTkTkTkTkTkTkTkTkTkTkTkTkTkTkTkTkTkTkTkTkTkTkTkTkTkTk
TkTkTkTkTkTkTkTkTkTkTkTkTkTkTkTkTkTkTkTkTkTkTkTkTkTkTkTkHgHgHgHgHgHgHgHgHgHgHgHgKgKgKgKgKgTkKgKgKgKgKgTkKgTkTkTkKgKgHgHgHgHgHgHgHgHgHgHgHgTkTkTkTkTkTkTkTkTkTkTkTkTkTkTkTkTkTkTkTkTkTkTkTkTkTkTkTkTkTkTk
TkTkTkTkTkTkTkTkTkTkTkTkTkTkTkTkTkTkTkTkTkTkTkTkTkTkTkTkTkTkHgHgHgHgHgHgHgHgHgHgHgHgKgKgKgTkKgKgKgTkTkTkKgTkTkTkKgKgHgHgHgHgHgHgHgHgHgHgTkTkTkTkTkTkTkTkTkTkTkTkTkTkTkTkTkTkTkTkTkTkTkTkTkTkTkTkTkTkTkTk
TkTkTkTkTkTkTkTkTkTkTkTkTkTkTkTkTkTkTkTkTkTkTkTkTkTkTkTkTkTkRnHgHgHgHgHgHgHgHgHgHgHgHgHgKgTkKgTkTkTkTkTkKgTkTkTkKgKgHgHgHgHgHgHgHgHgHgTkTkTkTkTkTkTkTkTkTkTkTkTkTkTkTkTkTkTkTkTkTkTkTkTkTkTkTkTkTkTkTkTk
TkTkTkTkTkTkTkTkTkTkTkTkTkTkTkTkTkTkTkTkTkTkTkTkTkTkTkTkTkTkRnTkHgHgHgHgHgHgHgHgHgHgHgHgKgTkKgTkTkTkTkTkKgTkTkTkKgKgHgHgHgHgHgHgHgHgHgTkTkTkTkTkTkTkTkTkTkTkTkTkTkTkTkTkTkTkTkTkTkTkTkTkTkTkTkTkTkTkTkTk
TkTkTkTkTkTkTkTkTkTkTkTkTkTkTkTkTkTkTkTkTkTkTkTkTkTkTkTkTkTkRnTkTkKgKgKgKgKgKgKgKgKgKgKgKgTkKgKgKgKgKgKgKgTkTkTkKgKgHgHgHgHgHgHgHgHgHgTkTkTkTkTkTkTkTkTkTkTkTkTkTkTkTkTkTkTkTkTkTkTkTkTkTkTkTkTkTkTkTkTk
TkTkTkTkTkTkTkTkTkTkTkTkTkTkTkTkTkTkTkTkTkTkTkTkTkTkTkTkTkTkRnTkTkKgTkTkTkTkKgTkTkTkTkTkTkTkTkTkTkTkTkTkKgTkTkTkKgHgHgHgHgHgHgHgHgHgHgTkTkTkTkTkTkTkTkTkTkTkTkTkTkTkTkTkTkTkTkTkTkTkTkTkTkTkTkTkTkTkTkTk
TkTkTkTkTkTkTkTkTkTkTkTkTkTkTkTkTkTkTkTkTkTkTkTkTkTkTkTkTkTkRnTkTkKgTkTkTkTkKgTkTkTkTkTkTkTkTkTkTkTkTkTkKgTkTkTkKgHgHgHgHgHgHgHgHgHgTkTkTkTkTkTkTkTkTkTkTkTkTkTkTkTkTkTkTkTkTkTkTkTkTkTkTkTkTkTkTkTkTkTk
TkTkTkTkTkTkTkTkTkTkTkTkTkTkTkTkTkTkTkTkTkTkTkTkTkTkTkTkTkTkRnTkTkKgTkTkTkTkKgTkTkTkTkTkTkTkTkTkTkTkTkTkKgTkTkTkKgHgHgHgHgHgHgHgTkTkTkTkTkTkTkTkTkTkTkTkTkTkTkTkTkTkTkTkTkTkTkTkTkTkTkTkTkTkTkTkTkTkTkTk
TkTkTkTkTkTkTkTkTkTkTkTkTkTkTkTkTkTkTkTkTkTkTkTkTkTkTkTkTkTkRnTkTkKgTkTkTkTkKgTkTkTkTkTkTkTkTkTkTkTkTkTkKgTkTkTkKgHgHgHgHgHgHgTkTkTkTkTkTkTkTkTkTkTkTkTkTkTkTkTkTkTkTkTkTkTkTkTkTkTkTkTkTkTkTkTkTkTkTkTk
TkTkTkTkTkTkTkTkTkTkTkTkTkTkTkTkTkTkTkTkTkTkTkTkTkTkTkTkTkTkRnTkTkKgKgKgKgKgKgKgKgKgKgKgKgKgKgKgKgKgKgKgKgKgTkKgKgHgHgHgHgHgTkTkTkTkTkTkTkTkTkTkTkTkTkTkTkTkTkTkTkTkTkTkTkTkTkTkTkTkTkTkTkTkTkTkTkTkTkTk
TkTkTkTkTkTkTkTkTkTkTkTkTkTkTkTkTkTkTkTkTkTkTkTkTkTkTkTkTkTkRnTkTkKgTkTkTkTkTkTkTkTkTkTkTkTkTkTkTkTkTkTkTkTkTkTkKgHgHgHgHgTkTkTkTkTkTkTkTkTkTkTkTkTkTkTkTkTkTkTkTkTkTkTkTkTkTkTkTkTkTkTkTkTkTkTkTkTkTkTk
TkTkTkTkTkTkTkTkTkTkTkTkTkTkTkTkTkTkTkTkTkTkTkTkTkTkTkTkTkTkRnTkTkKgTkTkTkTkTkTkTkTkTkTkTkTkTkTkTkTkTkTkTkTkTkTkKgHgHgHgTkTkTkTkTkTkTkTkTkTkTkTkTkTkTkTkTkTkTkTkTkTkTkTkTkTkTkTkTkTkTkTkTkTkTkTkTkTkTkTk
TkTkTkTkTkTkTkTkTkTkTkTkTkTkTkTkTkTkTkTkTkTkTkTkTkTkTkTkTkTkRnTkTkKgTkTkTkTkTkTkTkTkTkTkTkTkTkTkTkTkTkTkTkTkTkTkKgTkTkRnTkTkTkTkTkTkTkTkTkTkTkTkTkTkTkTkTkTkTkTkTkTkTkTkTkTkTkTkTkTkTkTkTkTkTkTkTkTkTkTk
TkTkTkTkTkTkTkTkTkTkTkTkTkTkTkTkTkTkTkTkTkTkTkTkTkTkTkTkTkTkRnTkTkKgTkTkTkTkTkTkTkTkTkTkTkTkTkTkTkTkTkTkTkTkKgKgKgTkTkRnTkTkTkTkTkTkTkTkTkTkTkTkTkTkTkTkTkTkTkTkTkTkTkTkTkTkTkTkTkTkTkTkTkTkTkTkTkTkTkTk
TkTkTkTkTkTkTkTkTkTkTkTkTkTkTkTkTkTkTkTkTkTkTkTkTkTkTkTkTkTkRnTkTkKgTkTkTkTkTkTkTkTkTkTkTkTkTkTkTkTkTkTkTkKgKgvwKgTkTkRnTkTkTkTkTkTkTkTkTkTkTkTkTkTkTkTkTkTkTkTkTkTkTkTkTkTkTkTkTkTkTkTkTkTkTkTkTkTkTkTk
TkTkTkTkTkTkTkTkTkTkTkTkTkTkTkTkTkTkTkTkTkTkTkTkTkTkTkTkTkTkRnTkTkKgTkTkTkTkTkTkTkTkTkTkTkTkTkTkTkTkTkTkKgKgIZEsKgTkTkRnTkTkTkTkTkTkTkTkTkTkTkTkTkTkTkTkTkTkTkTkTkTkTkTkTkTkTkTkTkTkTkTkTkTkTkTkTkTkTkTk
TkTkTkTkTkTkTkTkTkTkTkTkTkTkTkTkTkTkTkTkTkTkTkTkTkTkTkTkTkTkRnTkTkKgTkTkTkTkTkTkTkTkTkTkTkTkTkTkTkTkTkTkKgzheNWYKgTkTkRnTkTkTkTkTkTkTkTkTkTkTkTkTkTkTkTkTkTkTkTkTkTkTkTkTkTkTkTkTkTkTkTkTkTkTkTkTkTkTkTk
TkTkTkTkTkTkTkTkTkTkTkTkTkTkTkTkTkTkTkTkTkTkTkTkTkTkTkTkTkTkRnTkTkKgKgTkKgKgKgKgKgKgKgKgZIKgZIKgKgKgKgKgKgKgKgDtKgTkTkRnTkTkTkTkTkTkTkTkTkTkTkTkTkTkTkTkTkTkTkTkTkTkTkTkTkTkTkTkTkTkTkTkTkTkTkTkTkTkTkTk
TkTkTkTkTkTkTkTkTkTkTkTkTkTkTkTkTkTkTkTkTkTkTkTkTkTkTkTkTkTkRnTkTkKgTkTkTkTkTkTkTkTkKgZIZIZIZIZIKgBvBvBvBvKfKfKfKgTkTkRnTkTkTkTkTkTkTkTkTkTkTkTkTkTkTkTkTkTkTkTkTkTkTkTkTkTkTkTkTkTkTkTkTkTkTkTkTkTkTkTk
TkTkTkTkTkTkTkOSlqlqfulqlqnslqlqfulqlqnslqlqfulqlqnslqlqfulqeITkTkKgTkTkTkTkTkTkTkTkKgZIZIZIZIZIKgBvBvBvKgKfKfKfKgTkTkRnTkTkTkTkTkTkTkTkTkTkTkTkTkTkTkTkTkTkTkTkTkTkTkTkTkTkTkTkTkTkTkTkTkTkTkTkTkTkTkTk
TkTkTkTkTkTkTkRnTkTkTkTkTkTkTkTkTkTkTkTkTkTkTkTkTkTkTkTkTkTkTkTkTkKgTkTkTkTkTkTkTkTkKgZIZIZIZIZIKgKgKgKgKgKfKfKfKgTkTkRnTkTkTkTkTkTkTkTkTkTkTkTkTkTkTkTkTkTkTkTkTkTkTkTkTkTkTkTkTkTkTkTkTkTkTkTkTkTkTkTk
TkTkTkTkTkTkTkRnTkTkTkTkTkTkTkTkTkTkTkTkTkTkTkTkTkTkTkTkTkTkTkTkTkKgTkTkTkTkTkTkTkTkTkZIZIZIZIZIKgYnYnYnYnKfKfKfKgTkTkRnTkTkTkTkTkTkTkTkTkTkTkTkTkTkTkTkTkTkTkTkTkTkTkTkTkTkTkTkTkTkTkTkTkTkTkTkTkTkTkTk
TkTkTkTkTkTkTkRnTkTkTkTkTkTkaVaVaVaVaVaVaVaVaVKgKgKgKgKgKgKgKgKgKgKgTkTkTkTkTkTkTkTkTkZIZIZIZIZIKgYnYnYnKgKfKfKfKgTkTkRnTkTkTkTkTkTkTkTkTkTkTkTkTkTkTkTkTkTkTkTkTkTkTkTkTkTkTkTkTkTkTkTkTkTkTkTkTkTkTkTk
TkTkTkTkTkTkTkRnTkTkTkTkTkaVaVteteteteqIZMZMZMKgTkTkTkTkTkTkTkTkTkKgTkTkTkTkTkTkTkTkTkZIZIZIZIZIKgKgKgKgKgKfKfKfKgTkTkOSlqlqfulqlqnslqlqlqeITkTkTkTkTkTkTkTkTkTkTkTkTkTkTkTkTkTkTkTkTkTkTkTkTkTkTkTkTkTk
TkTkTkTkTkTkTkRnTkTkTkTkaVaVZMZMZMZMZMZMZMZMZMKgTkTkTkTkTkTkTkTkTkKgTkTkTkTkTkTkTkTkKgZIZIZIZIZIKgbFbFbFbFKfKfKfKgTkTkTkTkTkTkTkTkTkTkTkTkRnTkTkTkTkTkTkTkTkTkTkTkTkTkTkTkTkTkTkTkTkTkTkTkTkTkTkTkTkTkTk
TkTkTkTkTkTkTkRnTkTkTkaVaVZMZMZMZMZMZMZMdEnuouKgTkTkTkKgKgKgKgKgKgKgKgKgKgKgKgKgKgKgKgZIZIZIZIZIKgbFbFbFKgKfKfKfKgTkTkTkTkTkTkTkTkTkTkTkTkRnTkTkTkTkTkTkTkTkTkTkTkTkTkTkTkTkTkTkTkTkTkTkTkTkTkTkTkTkTkTk
TkTkTkTkTkTkTkRnTkTkaVaVZMiWZMZMJFZMZMZMFjDGInKgTkTkTkTkTkTkTkTkTkTkTkTkTkTkTkTkTkTkKgZIZIZIZIZIKgKgKgKgKgKgKfKfKgTkTkTkKgKgKgKgTkTkTkTkTkRnTkTkTkTkTkTkTkTkTkTkTkTkTkTkTkTkTkTkTkTkTkTkTkTkTkTkTkTkTkTk
TkTkTkTkTkTkTkRnTkTkaVZMZMZMOLZMZMZMTkZMGalCDGKgTkTkTkTkTkTkTkTkTkTkTkTkTkTkTkTkTkTkKgZIZIZIZIZIKgKfKfKfKfKfKfKfKgTkKgKgKgZIZIKgKgKgTkTkTkRnTkTkTkTkTkTkTkTkTkTkTkTkTkTkTkTkTkTkTkTkTkTkTkTkTkTkTkTkTkTk
TkTkTkTkTkTkTkRnTkTkaViWZMZMhrZMZMZMJFZMFjhZVdKgTkTkTkTkTkTkTkTkTkTkTkTkTkTkTkTkTkTkKgZIZIZIZIZIKgKfKfKfKfKfKfKfKgKgKgZIZIZIZIZIZIKgKgTkTkRnTkTkTkTkTkTkTkTkTkTkTkTkTkTkTkTkTkTkTkTkTkTkTkTkTkTkTkTkTkTk
TkTkTkTkTkTkTkRnTkTkaVZMZMZMZMZMZMZMZMZMVoszqYKgTkTkTkTkTkTkTkTkTkTkTkTkTkTkTkTkTkTkKgZIZIZIZIZIKfKfKfKfKfKfKfKfKgZIZIZIZIZIZIZIZIZIKgTkTkRnTkTkTkTkTkTkTkTkTkTkTkTkTkTkTkTkTkTkTkTkTkTkTkTkTkTkTkTkTkTk
TkTkTkTkTkTkTkRnTkTkaVeZeZeZeZeZeZZMZMZMZMZMZMKgTkTkTkTkTkTkTkTkTkTkTkTkKgKgKgKgKgKgKgZIZIZIZIZIKgKfKfKfKfKfKfKfKgZIZIZIZIZIZIZIZIZIKgTkTkRnTkTkTkTkTkTkTkTkTkTkTkTkTkTkTkTkTkTkTkTkTkTkTkTkTkTkTkTkTkTk
TkTkTkTkTkSBSBOqSBSBSBTkSBSBSBSBmJeZZMZMZMTkZMKgTkTkTkTkTkTkTkTkTkTkTkTkTkTkTkZIZIZIZIZIZIZIZIZIKgKfKfKfKfKfKfKfKgZIZIZIZIZIZIZIZIZIKgTkTkRnTkTkTkTkTkTkTkTkTkTkTkTkTkTkTkTkTkTkTkTkTkTkTkTkTkTkTkTkTkTk
TkTkTkTkTkTkTkOqSBSBSBSBSBSBSBSBXDZBZMZMZMZMZMKgTkTkTkTkTkTkTkTkTkTkTkTkTkTkTkZIZIZIZIZIZIZIZIZIKgKgKfKfKfKfKfKfKgZIZIZIZIZIZIZIZIZIKgTkTkRnTkTkTkTkTkTkTkTkTkTkTkTkTkTkTkTkTkTkTkTkTkTkTkTkTkTkTkTkTkTk
TkTkTkTkTkSBSBOqSBSBSBSBSBTkSBSBXDeZTkZMZMZMZMKgKgKgKgKgKgKgKgKgKgKgKgKgKgKgKgZIZIZIZIZIZIZIZIZIZIKgKgKgKgKgKgKgKgZIZIZIZIZIZIZIZIZIKgTkTkRnTkTkTkTkTkTkTkTkTkTkTkTkTkTkTkTkTkTkTkTkTkTkTkTkTkTkTkTkTkTk
TkTkTkTkTkTkTkaMDaDaDaDaDaDaDaDaJveZZMZMZMnwMgKgZIZIZIZIZIZIZIZIZIZIZIZIZIZIZIZIZIZIZIZIZIZIZIZIZIZIZIZIZIZIZIZIKgZIZIZIZIZIZIZIZIZIKgTkTkRnTkTkTkTkTkTkTkTkTkTkTkTkTkTkTkTkTkTkTkTkTkTkTkTkTkTkTkTkTkTk
TkTkTkTkTkTkSBOqSBSBSBSBSBSBSBSBXDeZZMZMnwIWAtubZIZIZIZIZIZIZIZIZIZIZIZIZIZIZIZIZIZIZIZIZIZIZIZIZIZIZIZIZIZIZIZIZIZIZIZIZIZIZIZIZIZIKgTkTkRnTkTkTkTkTkTkTkTkTkTkTkTkTkTkTkTkTkTkTkTkTkTkTkTkTkTkTkTkTkTk
TkTkTkTkTkSBSBOqSBSBSBSBSBSBSBTkXDeZZMZMrvAtAtKgZIZIZIZIZIZIZIZIZIZIZIZIZIZIZIZIZIZIZIZIZIZIZIZIZIZIZIZIZIZIZIZIKgZIZIZIZIZIZIZIZIZIKgTkTkRnTkTkTkTkTkTkTkTkTkTkTkTkTkTkTkTkTkTkTkTkTkTkTkTkTkTkTkTkTkTk
TkTkTkTkTkTkSBOqSBSBTkSBSBSBSBSBXDZBZMZMxkTkAtubZIZIZIZIZIZIZIZIZIZIZIZIZIZIZIZIZIZIZIZIZIZIZIZIZIZIZIZIZIZIZIZIZIZIZIZIZIZIZIZIZIKgKgTkTkRnTkTkTkTkTkTkTkTkTkTkTkTkTkTkTkTkTkTkTkTkTkTkTkTkTkTkTkTkTkTk
TkTkTkTkTkSBSBOqSBSBSBSBSBSBSBSBXDeZZMZMZMxkEPKgZIZIZIZIZIZIZIZIZIZIZIZIZIZIZIZIZIZIZIZIZIZIZIZIZIZIZIZIZIZIZIZIKgZIZIZIZIZIZIZIKgKgTkTkTkRnTkTkTkTkTkTkTkTkTkTkTkTkTkTkTkTkTkTkTkTkTkTkTkTkTkTkTkTkTkTk
TkTkTkTkTkTkTkRnTkTkaVaVaVaVaVaVaVaVaVaVaVaVaVKgKgKgKgKgKgKgKgKgKgKgKgKgKgKgKgKgKgKgKgKgZIKgZIKgKgKgKgKgKgKgKgKgKgKgKgKgKgKgKgKgKgTkTkTkTkRnTkTkTkTkTkTkTkTkTkTkTkTkTkTkTkTkTkTkTkTkTkTkTkTkTkTkTkTkTkTk
TkTkTkTkTkTkTkRnTkTkTkTkTkTkTkTkTkTkTkTkTkTkTkTkTkTkTkTkTkTkTkTkTkTkTkTkKgZIZIZIZIZIZIZIZIZIZIZIZIZIZIZIZIKgTkTkTkTkTkTkTkTkTkTkTkTkTkTkTkRnTkTkTkTkTkTkTkTkTkTkTkTkTkTkTkTkTkTkTkTkTkTkTkTkTkTkTkTkTkTk
TkTkTkTkTkTkTkRnTkTkTkTkTkTkTkTkTkTkTkTkTkTkTkTkTkTkTkTkTkTkTkTkTkTkTkTkKgZIZIZIZIZIZIZIZIZIZIZIZIZIZIZIZIKgTkTkTkTkTkTkTkTkTkTkTkTkTkTkTkRnTkTkTkTkTkTkTkTkTkTkTkTkTkTkTkTkTkTkTkTkTkTkTkTkTkTkTkTkTkTk
TkTkTkTkTkTkTkOSfulqlqnslqlqfulqlqnslqlqfulqlqnslqlqfulqlqnslqlqfueITkTkKgZIZIZIZIZIZIZIZIZIZIZIZIZIZIZIZIKgTkTkOSlqlqnslqlqfulqlqnslqlqfueITkTkTkTkTkTkTkTkTkTkTkTkTkTkTkTkTkTkTkTkTkTkTkTkTkTkTkTkTkTk
TkTkTkTkTkTkTkTkTkTkTkTkTkTkTkTkTkTkTkTkTkTkTkTkTkTkTkTkTkTkTkTkTkRnTkTkKgZIZIZIZIZIZIZIZIZIZIZIZIZIZIZIZIKgTkTkRnTkTkTkTkTkTkTkTkTkTkTkTkTkTkTkTkTkTkTkTkTkTkTkTkTkTkTkTkTkTkTkTkTkTkTkTkTkTkTkTkTkTkTk
TkTkTkTkTkTkTkTkTkTkTkTkTkTkTkTkTkTkTkTkTkTkTkTkTkTkTkTkTkTkTkTkTkRnTkTkKgZIZIZIZIZIZIZIZIZIZIZIZIZIZIZIZIKgTkTkRnTkTkTkTkTkTkTkTkTkTkTkTkTkTkTkTkTkTkTkTkTkTkTkTkTkTkTkTkTkTkTkTkTkTkTkTkTkTkTkTkTkTkTk
TkTkTkTkTkTkTkTkTkTkTkTkTkTkTkTkTkTkTkTkTkTkTkTkTkTkTkTkTkTkTkTkTkRnTkTkKgZIZIZIZIZIZIZIZIZIZIZIZIZIZIZIZIKgTkTkRnTkTkTkTkTkTkTkTkTkTkTkTkTkTkTkTkTkTkTkTkTkTkTkTkTkTkTkTkTkTkTkTkTkTkTkTkTkTkTkTkTkTkTk
TkTkTkTkTkTkTkTkTkTkTkTkTkTkTkTkTkTkTkTkTkTkTkTkTkTkTkTkTkTkTkTkTkRnTkTkKgKgKgTkTkKgKgKgKgKgKgKgKgTkTkKgKgKgTkTkRnTkTkTkTkTkTkTkTkTkTkTkTkTkTkTkTkTkTkTkTkTkTkTkTkTkTkTkTkTkTkTkTkTkTkTkTkTkTkTkTkTkTkTk
TkTkTkTkTkTkTkTkTkTkTkTkTkTkTkTkTkTkTkTkTkTkTkTkTkTkTkTkTkTkTkTkTkRnTkTkTkTkTkTkTkTkTkTkTkTkTkTkTkTkTkTkTkTkTkTkRnTkTkTkTkTkTkTkTkTkTkTkTkTkTkTkTkTkTkTkTkTkTkTkTkTkTkTkTkTkTkTkTkTkTkTkTkTkTkTkTkTkTkTk
TkTkTkTkTkTkTkTkTkTkTkTkTkTkTkTkTkTkTkTkTkTkTkTkTkTkTkTkTkTkTkTkTkRnTkTkTkTkTkTkTkTkTkTkTkTkTkTkTkTkTkTkTkTkTkTkRnTkTkTkTkTkTkTkTkTkTkTkTkTkTkTkTkTkTkTkTkTkTkTkTkTkTkTkTkTkTkTkTkTkTkTkTkTkTkTkTkTkTkTk
TkTkTkTkTkTkTkTkTkTkTkTkTkTkTkTkTkTkTkTkTkTkTkTkTkTkTkTkTkTkTkTkTkOSlqlqnslqlqfulqlqnslqlqfulqlqnslqlqfulqlqnslqeITkTkTkTkTkTkTkTkTkTkTkTkTkTkTkTkTkTkTkTkTkTkTkTkTkTkTkTkTkTkTkTkTkTkTkTkTkTkTkTkTkTkTk
TkTkTkTkTkTkTkTkTkTkTkTkTkTkTkTkTkTkTkTkTkTkTkTkTkTkTkTkTkTkTkTkTkTkTkTkTkTkTkTkTkTkTkTkTkTkTkTkTkTkTkTkTkTkTkTkTkTkTkTkTkTkTkTkTkTkTkTkTkTkTkTkTkTkTkTkTkTkTkTkTkTkTkTkTkTkTkTkTkTkTkTkTkTkTkTkTkTkTkTk
TkTkTkTkTkTkTkTkTkTkTkTkTkTkTkTkTkTkTkTkTkTkTkTkTkTkTkTkTkTkTkTkTkTkTkTkTkTkTkTkTkTkTkTkTkTkTkTkTkTkTkTkTkTkTkTkTkTkTkTkTkTkTkTkTkTkTkTkTkTkTkTkTkTkTkTkTkTkTkTkTkTkTkTkTkTkTkTkTkTkTkTkTkTkTkTkTkTkTkTk
TkTkTkTkTkTkTkTkTkTkTkTkTkTkTkTkTkTkTkTkTkTkTkTkTkTkTkTkTkTkTkTkTkTkTkTkTkTkTkTkTkTkTkTkTkTkTkTkTkTkTkTkTkTkTkTkTkTkTkTkTkTkTkTkTkTkTkTkTkTkTkTkTkTkTkTkTkTkTkTkTkTkTkTkTkTkTkTkTkTkTkTkTkTkTkTkTkTkTkTk
TkTkTkTkTkTkTkTkTkTkTkTkTkTkTkTkTkTkTkTkTkTkTkTkTkTkTkTkTkTkTkTkTkTkTkTkTkTkTkTkTkTkTkTkTkTkTkTkTkTkTkTkTkTkTkTkTkTkTkTkTkTkTkTkTkTkTkTkTkTkTkTkTkTkTkTkTkTkTkTkTkTkTkTkTkTkTkTkTkTkTkTkTkTkTkTkTkTkTkTk
TkTkTkTkTkTkTkTkTkTkTkTkTkTkTkTkTkTkTkTkTkTkTkTkTkTkTkTkTkTkTkTkTkTkTkTkTkTkTkTkTkTkTkTkTkTkTkTkTkTkTkTkTkTkTkTkTkTkTkTkTkTkTkTkTkTkTkTkTkTkTkTkTkTkTkTkTkTkTkTkTkTkTkTkTkTkTkTkTkTkTkTkTkTkTkTkTkTkTkTk
TkTkTkTkTkTkTkTkTkTkTkTkTkTkTkTkTkTkTkTkTkTkTkTkTkTkTkTkTkTkTkTkTkTkTkTkTkTkTkTkTkTkTkTkTkTkTkTkTkTkTkTkTkTkTkTkTkTkTkTkTkTkTkTkTkTkTkTkTkTkTkTkTkTkTkTkTkTkTkTkTkTkTkTkTkTkTkTkTkTkTkTkTkTkTkTkTkTkTkTk
TkTkTkTkTkTkTkTkTkTkTkTkTkTkTkTkTkTkTkTkTkTkTkTkTkTkTkTkTkTkTkTkTkTkTkTkTkTkTkTkTkTkTkTkTkTkTkTkTkTkTkTkTkTkTkTkTkTkTkTkTkTkTkTkTkTkTkTkTkTkTkTkTkTkTkTkTkTkTkTkTkTkTkTkTkTkTkTkTkTkTkTkTkTkTkTkTkTkTkTk
TkTkTkTkTkTkTkTkTkTkTkTkTkTkTkTkTkTkTkTkTkTkTkTkTkTkTkTkTkTkTkTkTkTkTkTkTkTkTkTkTkTkTkTkTkTkTkTkTkTkTkTkTkTkTkTkTkTkTkTkTkTkTkTkTkTkTkTkTkTkTkTkTkTkTkTkTkTkTkTkTkTkTkTkTkTkTkTkTkTkTkTkTkTkTkTkTkTkTkTk
TkTkTkTkTkTkTkTkTkTkTkTkTkTkTkTkTkTkTkTkTkTkTkTkTkTkTkTkTkTkTkTkTkTkTkTkTkTkTkTkTkTkTkTkTkTkTkTkTkTkTkTkTkTkTkTkTkTkTkTkTkTkTkTkTkTkTkTkTkTkTkTkTkTkTkTkTkTkTkTkTkTkTkTkTkTkTkTkTkTkTkTkTkTkTkTkTkTkTkTk
TkTkTkTkTkTkTkTkTkTkTkTkTkTkTkTkTkTkTkTkTkTkTkTkTkTkTkTkTkTkTkTkTkTkTkTkTkTkTkTkTkTkTkTkTkTkTkTkTkTkTkTkTkTkTkTkTkTkTkTkTkTkTkTkTkTkTkTkTkTkTkTkTkTkTkTkTkTkTkTkTkTkTkTkTkTkTkTkTkTkTkTkTkTkTkTkTkTkTkTk
TkTkTkTkTkTkTkTkTkTkTkTkTkTkTkTkTkTkTkTkTkTkTkTkTkTkTkTkTkTkTkTkTkTkTkTkTkTkTkTkTkTkTkTkTkTkTkTkTkTkTkTkTkTkTkTkTkTkTkTkTkTkTkTkTkTkTkTkTkTkTkTkTkTkTkTkTkTkTkTkTkTkTkTkTkTkTkTkTkTkTkTkTkTkTkTkTkTkTkTk
TkTkTkTkTkTkTkTkTkTkTkTkTkTkTkTkTkTkTkTkTkTkTkTkTkTkTkTkTkTkTkTkTkTkTkTkTkTkTkTkTkTkTkTkTkTkTkTkTkTkTkTkTkTkTkTkTkTkTkTkTkTkTkTkTkTkTkTkTkTkTkTkTkTkTkTkTkTkTkTkTkTkTkTkTkTkTkTkTkTkTkTkTkTkTkTkTkTkTkTk
TkTkTkTkTkTkTkTkTkTkTkTkTkTkTkTkTkTkTkTkTkTkTkTkTkTkTkTkTkTkTkTkTkTkTkTkTkTkTkTkTkTkTkTkTkTkTkTkTkTkTkTkTkTkTkTkTkTkTkTkTkTkTkTkTkTkTkTkTkTkTkTkTkTkTkTkTkTkTkTkTkTkTkTkTkTkTkTkTkTkTkTkTkTkTkTkTkTkTkTk
"}
